00000000001000000100
00000000001000000100
00111111001001111100
00001000000001000000
22000000000001000033
22100010011001000133
22000010000000000033
00000010000000010000
00111110010011111100
00100000010000000000
00100000010000000000