00000000011000000000
00000000011000000000
00110010011001001100
00010010000001001000
22000010000001000033
22000010011001000033
22000010000001000033
00010010000001001000
00110010011001001100
00000000011000000000
00000000011000000000