00000011000011000000
00110010000001000100
00100010011000001100
00100100001000001000
22000100000001000033
22000100000000100033
22000010000000100033
00010000010000100100
00110000011001000100
00100010000001001100
00000011000011000000