00000000011000000000
00000000011000000000
01111110001001111100
00000010000001000000
22000011100001000033
22010011000011001033
22000010000111000033
00000010000001000000
01111110010001111100
00000000011000000000
00000000011000000000