00110010000001001100
00010010000000001000
00010000011000001000
00110000010001001100
22000010010001000033
22000010011001000033
22000010001001000033
00110010001000001100
00010000011000001000
00010000000001001000
00110010000001001100